{
    "tileCols": 5,
    "tileRows": 5,
    "tileWidth": 32,
    "tileHeight": 32,    
    "tileMapCols": 32,
    "tileMapRows": 32,
    "tileMapTileWidth": 32,
    "tileMapTileHeight": 32,
    "tileMapImageKey": "tilemap",
    "visualLayers": [
        [0,115,63,115,115, 115,115,63,115,115, 115,115,63,115,115, 115,115,63,115,115, 115,115,63,115,115],
        [391,115,63,115,115, 115,115,63,115,115, 115,115,63,115,115, 115,115,63,115,115, 115,115,63,115,115],
        [391,115,63,115,115, 115,115,63,115,115, 115,115,63,115,115, 115,115,63,115,115, 115,115,63,115,115],
        [391,115,63,115,115, 115,115,63,115,115, 115,115,63,115,115, 115,115,63,115,115, 115,115,63,115,115],
        [391,0,63,115,115, 115,115,63,115,115, 115,115,63,115,115, 115,115,63,115,115, 115,115,63,115,115]
    ]
}